###################
#...$$..$$$.......#
#.#$#.#.#.#.#.#$#.#
#$....$........$.$#
#.#.#.#$#.#.#.#.#.#
#.................#
#.#.#.#.#.#.#.#.#.#
#..............$..#
#.#.#.#.#.#.#.#$#.#
#.................#
#.#.#.#.#.#.#.#.#.#
#.................#
#.#.#.#.#.#.#.#.#.#
#$$$............$$#
#.#$#.#.#.#.#.#$#.#
#..$..............#
###################
