###################
#...$$..$$$.......#
#.#$#.#.#.#.#.#$#.#
#$....$........$.$#
#.#.#.#$#.#.#.#.#.#
#.................#
#.#.#.#.#.#.#.#.#.#
#.........$....$..#
#.#.#.#.#.#.#.#$#.#
#...$...$.$......$#
#.#.#.#.#.#.#.#.#$#
#...$..$...$..$..$#
#.#.#.#.#.#.#.#.#$#
#$$$............$$#
#$#$#.#.#.#.#.#$#.#
#..$.........$....#
###################
