#################
##..$..........##
##.#$#.#.#.#.#$##
##..$...$.$...$##
##.#.#.#.#.#.#$##
##$$.$..$.$..$$##
##.#.#.#.#.#.#.##
##......$...$..##
##.#$#.#.#.#$#.##
##...$..$...$..##
##.#$#.#.#.#.#.##
##..$..$.$.....##
#################