#################
##..#..........##
##.#.#.#.#.#.#.##
##$..$$.....#..##
##.###.#.#$#.#.##
##$.......$...$##
##$#.#.#.#$#.#.##
##$.........$$.##
##.#.#.#.#.#.#.##
##........$....##
##$#.#.#.#$#.#.##
##..$.$.$.$....##
#################